NO ./files/player_heart.xpm
SO ./files/player_heart.xpm
WE ./files/green.xpm
EA ./files/player_heart.xpm

C 0,0,0
F 125,125,125


        1111111111111111111111111
        1000000001110000000000001
        1000000003330000000000401
111111111000000001110000000000001
100000000000000001113311111111111
111331111111111111000000100011
111331111111111111000000104011
100000000000000011000000100011
100000000000000011000000100011
100000000000000011000000100011
100000000000000011000000100011
100000000000000011000000000011
1111113331111111111111111111111
1000040000000000000000000000001
1000050000000000000000000000001
1000000000000000000000000000001
1000000000000000000300000000W01
1000000000000000000000000000001
1000000000000000000000000000001
1000000000000000000000000000001
1111111111111111111111111111111