NO ./files/mandatory_tex/wall_00_01.xpm
SO ./files/mandatory_tex/wall_00_02.xpm
WE ./files/mandatory_tex/wall_00_03.xpm
EA ./files/mandatory_tex/wall_00_07.xpm

C 32,35,40
F 42,45,52


        1111111111111111111111111
        1000000051110000000000001
        1000000003330050000040501
111111111000000001110000000000001
100000000004050001113311111111111
11133111111111111100000011011
11133111111111111101001010401
10000000000000341100000015051
10000000000000331103003010001
10005000000000001100000013331
10000000000005001101001010001
10000000000000001100000000001
1111113331111111111111111111111
1500000000000000000000000000001
1000050000000000000000000000001
1000005000000000100000000000001
1005000000000000000000000000W01
1000050450000000000000030000001
1050000010000000000000000000001
1500000000000000000000000000001
1111111111111111111111111111111